File pattern: can read (pattern)
Zip: can read (zip)
Animated PNG: can read, can write, can write multiple (png)
JPEG: can read, can write (jpg, jpeg, jpe)
Portable Any Map: can read (pbm, pgm, ppm)
Flexible Image Transport System: can read (fits, fts)
PCX: can read (pcx)
Graphics Interchange Format: can read (gif)
Windows Bitmap: can read (bmp)
IPLab: can read (ipl)
IVision: can read (ipm)
Deltavision: can read (dv, r3d, r3d_d3d, dv.log, r3d.log)
Medical Research Council: can read (mrc, st, ali, map, rec, mrcs)
Gatan Digital Micrograph: can read (dm3, dm4)
Gatan DM2: can read (dm2)
Bitplane Imaris: can read (ims)
Openlab RAW: can read (raw)
OME-XML: can read, can write, can write multiple (ome, ome.xml)
Leica Image File Format: can read (lif)
Audio Video Interleave: can read, can write, can write multiple (avi)
PICT: can read (pict, pct)
SPCImage Data: can read (sdt)
SPC FIFO Data: can read (spc, set)
Encapsulated PostScript: can read, can write (eps, epsi, ps)
Olympus Slidebook: can read (sld, spl)
Alicona AL3D: can read (al3d)
Multiple-image Network Graphics: can read (mng)
Khoros XV: can read (xv)
Visitech XYS: can read (xys, html)
Laboratory Imaging: can read (lim)
Adobe Photoshop: can read (psd)
InCell 1000/2000: can read (xdce, xml, tiff, tif, xlog)
Li-Cor L2D: can read (l2d, scn, tif)
FEI/Philips: can read (img)
Hamamatsu Aquacosmos: can read (naf)
MINC MRI: can read (mnc)
QuickTime: can read, can write, can write multiple (mov)
Minolta MRW: can read (mrw)
TillVision: can read (vws, pst, inf)
ARF: can read (arf)
Cellomics C01: can read (c01, dib)
LI-FLIM: can read (fli)
Truevision Targa: can read (tga)
Oxford Instruments: can read (top)
VG SAM: can read (dti)
Hamamatsu HIS: can read (his)
WA Technology TOP: can read (wat)
Seiko: can read (xqd, xqf)
TopoMetrix: can read (tfr, ffr, zfr, zfp, 2fl)
UBM: can read (pr3)
Quesant AFM: can read (afm)
Bio-Rad GEL: can read (1sc)
RHK Technologies: can read (sm2, sm3)
Molecular Imaging: can read (stp)
CellWorx: can read (pnl, htd, log)
ECAT7: can read (v)
Varian FDF: can read (fdf)
AIM: can read (aim)
InCell 3000: can read (frm)
SPIDER: can read (spi)
Volocity Library: can read (mvd2, aisf, aiix, dat, atsf)
IMAGIC: can read (hed, img)
Hamamatsu VMS: can read (vms)
CellSens VSI: can read (vsi, ets)
INR: can read (inr)
Kodak Molecular Imaging: can read (bip)
Volocity Library Clipping: can read (acff)
Zeiss CZI: can read (czi)
Andor SIF: can read (sif)
Hamamatsu NDPIS: can read (ndpis)
POV-Ray: can read (df3)
IMOD: can read (mod)
Simulated data: can read (fake)
Aperio AFI: can read (afi)
Lavision Imspector: can read (msr)
Bio-Rad SCN: can read (scn)
Zeiss LMS: can read (lms)
PicoQuant Bin: can read (bin)
FlowSight: can read (cif)
Perkin-Elmer Nuance IM3: can read (im3)
I2I: can read (i2i)
Princeton Instruments SPE: can read (spe)
Olympus OIR: can read (oir)
JEOL: can read (dat, img, par)
NIfTI: can read (nii, img, hdr, nii.gz)
Analyze 7.5: can read (img, hdr)
Olympus APL: can read (apl, tnb, mtb, tif)
NRRD: can read (nrrd, nhdr)
Image Cytometry Standard: can read, can write, can write multiple (ics, ids)
PerkinElmer: can read (ano, cfg, csv, htm, rec, tim, zpo, tif)
Amira: can read (am, amiramesh, grey, hx, labels)
Olympus ScanR: can read (dat, xml, tif)
BD Pathway: can read (exp, tif)
Unisoku STM: can read (hdr, dat)
Perkin Elmer Densitometer: can read (hdr, img)
Fuji LAS 3000: can read (img, inf)
PerkinElmer Operetta: can read (tif, tiff, xml)
Inveon: can read (hdr)
CellVoyager: can read (tif, xml)
PerkinElmer Columbus: can read (xml)
Bio-Rad PIC: can read (pic, xml, raw)
Olympus FV1000: can read (oib, oif, pty, lut)
Zeiss Vision Image (ZVI): can read (zvi)
Image-Pro Workspace: can read (ipw)
JPEG-2000: can read, can write (jp2, j2k, jpf)
JPX: can read (jpx)
Nikon ND2: can read (nd2)
Compix Simple-PCI: can read (cxd)
Bitplane Imaris 5.5 (HDF): can read (ims)
CellH5 (HDF): can read (ch5)
Woolz: can read, can write, can write multiple (wlz)
Veeco: can read (hdf)
Zeiss Laser-Scanning Microscopy: can read (lsm, mdb)
Image-Pro Sequence: can read (seq)
Amersham Biosciences GEL: can read (gel)
Bitplane Imaris 3 (TIFF): can read (ims)
Evotec Flex: can read (flex, mea, res)
Aperio SVS: can read (svs)
Imacon: can read (fff)
LEO: can read (sxm, tif, tiff)
JPK Instruments: can read (jpk)
Hamamatsu NDPI: can read (ndpi)
PCO-RAW: can read (pcoraw, rec)
OME-TIFF: can read, can write, can write multiple (ome.tiff, ome.tif, ome.tf2, ome.tf8, ome.btf, companion.ome)
Pyramid TIFF: can read (tif, tiff)
MIAS: can read (tif, tiff, txt)
Leica TCS TIFF: can read (tif, tiff, xml)
Leica: can read (lei, tif, tiff, raw)
Nikon NEF: can read (nef, tif, tiff)
Olympus Fluoview/ABD TIFF: can read (tif, tiff)
Prairie TIFF: can read (tif, tiff, cfg, env, xml)
Metamorph STK: can read (stk, nd, tif, tiff)
Micro-Manager: can read (tif, tiff, txt, xml)
Improvision TIFF: can read (tif, tiff)
Metamorph TIFF: can read (tif, tiff)
Nikon TIFF: can read (tif, tiff)
Adobe Photoshop TIFF: can read (tif, tiff)
FEI TIFF: can read (tif, tiff)
SimplePCI TIFF: can read (tif, tiff)
Nikon Elements TIFF: can read (tif, tiff)
Trestle: can read (tif)
Olympus SIS TIFF: can read (tif, tiff)
DNG: can read (cr2, crw, jpg, thm, wav, tif, tiff)
Zeiss AxioVision TIFF: can read (tif, xml)
Leica SCN: can read (scn)
Slidebook TIFF: can read (tif, tiff)
Tagged Image File Format: can read, can write, can write multiple (tif, tiff, tf2, tf8, btf)
Text: can read (txt, csv)
Burleigh: can read (img)
Openlab LIFF: can read (liff)
DICOM: can read (dic, dcm, dicom, jp2, j2ki, j2kr, raw, ima)
SM Camera: can read ()
SBIG: can read ()
NOAA-HRD Gridded Data Format: can read ()
Hitachi: can read (txt)
Bruker: can read ()
Canon RAW: can read (cr2, crw, jpg, thm, wav)
OBF: can read (obf, msr)